{
  "version": 1,
  "name": "tiny-town",
  "width": 20,
  "height": 15,
  "tileSize": 16,
  "tileset": "/games/tiny-town/assets/kenney_tiny-town_tilesets.json",
  "tiles": [
    0, 0, 0, 0, 0, 0, 0, 0, 0, 0, 0, 0, 0, 0, 0, 0, 0, 0, 0, 0,
    0, 0, 0, 1, 0, 0, 0, 2, 0, 0, 0, 0, 0, 0, 0, 0, 0, 0, 0, 2,
    0, 1, 0, 0, 0, 0, 0, 1, 0, 0, 0, 2, 0, 0, 2, 0, 0, 0, 0, 0,
    0, 1, 0, 0, 2, 0, 0, 1, 0, 0, 0, 0, 0, 0, 0, 0, 0, 0, 0, 0,
    0, 1, 0, 0, 0, 0, 0, 0, 0, 0, 0, 0, 0, 0, 0, 0, 0, 0, 0, 0,
    0, 12, 13, 13, 13, 13, 13, 13, 13, 13, 13, 14, 0, 0, 0, 96, 97, 97, 97, 98,
    0, 24, 25, 25, 25, 25, 25, 25, 25, 25, 25, 26, 0, 0, 0, 108, 109, 109, 109, 110,
    0, 24, 25, 25, 25, 25, 25, 25, 25, 25, 25, 25, 2, 1, 2, 108, 109, 109, 109, 110,
    0, 24, 25, 25, 25, 25, 25, 25, 25, 25, 25, 25, 13, 13, 13, 109, 109, 109, 109, 110,
    0, 24, 25, 25, 25, 25, 25, 25, 25, 25, 25, 25, 37, 37, 37, 109, 109, 109, 109, 110,
    0, 36, 37, 37, 37, 37, 37, 37, 37, 37, 37, 38, 1, 1, 0, 108, 109, 109, 109, 110,
    0, 0, 2, 0, 0, 0, 0, 0, 0, 0, 0, 0, 0, 2, 0, 108, 109, 109, 109, 110,
    0, 0, 0, 0, 0, 0, 0, 0, 0, 0, 2, 0, 0, 0, 0, 120, 121, 121, 121, 122,
    0, 0, 0, 2, 0, 0, 2, 0, 0, 0, 0, 0, 0, 0, 0, 0, 0, 0, 0, 0,
    0, 2, 0, 0, 0, 0, 0, 2, 0, 0, 0, 0, 2, 0, 0, 2, 0, 0, 0, 0
  ],
  "spawnPoint": { "x": 10, "y": 7 }
}
