{
  "version": 1,
  "name": "dungeon_01",
  "width": 20,
  "height": 15,
  "tileSize": 64,
  "tileset": "/games/dungeon/assets/dungeon_tilesets.json",
  "tiles": [
    47, 47, 47, 47, 47, 47, 47, 47, 47, 47, 47, 47, 47, 47, 47, 47, 47, 47, 47, 47,
    47, 47, 47, 47, 47, 47, 47, 47, 47, 47, 47, 47, 47, 47, 47, 47, 47, 47, 47, 47,
    47, 47, 47, 47, 47, 47, 47, 47, 47, 47, 46, 55, 55, 55, 47, 47, 47, 47, 47, 47,
    47, 47, 47, 47, 47, 47, 47, 47, 47, 47, 46, 55, 55, 55, 47, 47, 47, 47, 47, 47,
    47, 47, 47, 47, 47, 47, 47, 47, 47, 47, 46, 55, 55, 55, 47, 47, 47, 47, 47, 47,
    47, 47, 47, 47, 47, 47, 47, 47, 47, 47, 46, 55, 55, 55, 47, 47, 47, 47, 47, 47,
    47, 47, 47, 47, 47, 47, 47, 47, 47, 47, 46, 55, 55, 55, 47, 47, 47, 47, 47, 47,
    47, 47, 47, 47, 47, 47, 47, 47, 47, 47, 46, 55, 55, 55, 47, 47, 47, 47, 47, 47,
    47, 47, 47, 47, 47, 47, 47, 47, 47, 47, 46, 55, 55, 55, 47, 47, 47, 47, 47, 47,
    47, 47, 47, 47, 47, 47, 47, 47, 47, 47, 46, 55, 55, 55, 47, 47, 47, 47, 47, 47,
    47, 47, 47, 47, 47, 47, 47, 47, 47, 47, 46, 55, 55, 55, 47, 47, 47, 47, 47, 47,
    47, 47, 47, 47, 47, 47, 47, 47, 47, 47, 46, 55, 55, 55, 47, 47, 47, 47, 47, 47,
    47, 47, 47, 47, 47, 47, 47, 47, 47, 47, 46, 55, 55, 55, 47, 47, 47, 47, 47, 47,
    47, 47, 47, 47, 47, 47, 47, 47, 47, 47, 47, 47, 47, 47, 47, 47, 47, 47, 47, 47,
    47, 47, 47, 47, 47, 47, 47, 47, 47, 47, 47, 47, 47, 47, 47, 47, 47, 47, 47, 47
  ],
  "spawnPoint": {
    "x": 10,
    "y": 7
  }
}