{
  "version": 1,
  "name": "room_04",
  "width": 16,
  "height": 12,
  "tileSize": 64,
  "tiles": [
    0, 0, 0, 0, 0, 0, 0, 0, 0, 0, 0, 0, 0, 0, 0, 0,
    0, 0, 7, 7, 0, 0, 0, 0, 0, 0, 0, 0, 0, 9, 9, 0,
    0, 0, 7, 7, 0, 0, 0, 0, 0, 0, 0, 0, 0, 9, 9, 0,
    0, 0, 7, 7, 0, 0, 0, 0, 0, 0, 0, 0, 0, 9, 9, 0,
    0, 0, 7, 7, 0, 0, 0, 0, 0, 0, 0, 0, 0, 9, 9, 0,
    0, 0, 7, 7, 0, 0, 0, 0, 0, 0, 0, 0, 0, 9, 9, 0,
    0, 0, 0, 0, 0, 0, 0, 0, 0, 0, 0, 0, 0, 0, 0, 0,
    0, 0, 0, 0, 0, 0, 0, 0, 0, 0, 0, 0, 0, 0, 0, 0,
    0, 0, 0, 0, 0, 0, 0, 0, 0, 0, 0, 0, 0, 0, 0, 0,
    0, 0, 0, 0, 0, 0, 0, 0, 0, 0, 0, 0, 0, 0, 0, 0,
    0, 0, 0, 0, 0, 0, 0, 0, 0, 0, 0, 0, 0, 0, 0, 0,
    0, 0, 0, 0, 0, 0, 0, 0, 0, 0, 0, 0, 0, 0, 0, 0
  ],
  "spawnPoint": {
    "x": 8,
    "y": 6
  }
}